01 02 03 04 01 02 03 04 01 02 03 04 01 02 03 04 01
05 07 09 11 05 07 09 11 05 07 09 11 05 07 09 11 05
06 08 10 12 06 08 10 12 06 08 10 12 06 08 10 12 06
01 02 03 04 01 02 03 04 01 02 03 04 01 02 03 04 01
05 07 09 11 05 07 09 11 05 07 09 11 05 07 09 11 05
06 08 10 12 06 08 10 12 06 08 10 12 06 08 10 12 06
01 02 03 04 01 02 03 04 01 02 03 04 01 02 03 04 01
05 07 09 11 05 07 09 11 05 07 09 11 05 07 09 11 05
06 08 10 12 06 08 10 12 06 08 10 12 06 08 10 12 06
01 02 03 04 01 02 03 04 01 02 03 04 01 02 03 04 01
05 07 09 11 05 07 09 11 05 07 09 11 05 07 09 11 05
06 08 10 12 06 08 10 12 06 08 10 12 06 08 10 12 06
01 02 03 04 01 02 03 04 01 02 03 04 01 02 03 04 01
05 07 09 11 05 07 09 11 05 07 09 11 05 07 09 11 05
06 08 10 12 06 08 10 12 06 08 10 12 06 08 10 12 06
01 02 03 04 01 02 03 04 01 02 03 04 01 02 03 04 01
05 07 09 11 05 07 09 11 05 07 09 11 05 07 09 11 05
06 08 10 12 06 08 10 12 06 08 10 12 06 08 10 12 06
01 02 03 04 01 02 03 04 01 02 03 04 01 02 03 04 01
05 07 09 11 05 07 09 11 05 07 09 11 05 07 09 11 05
06 08 10 12 06 08 10 12 06 08 10 12 06 08 10 12 06
