13 14 14 14 14 14 14 14 14 14 14 14 15
03 01 02 03 04 01 02 03 04 01 02 03 01
09 05 07 09 11 05 07 09 11 05 07 09 05
10 06 08 10 12 06 08 10 12 06 08 10 06
03 01 02 03 01 14 14 14 04 01 02 03 01
09 05 07 09 11 05 07 09 11 05 07 09 05
10 06 08 10 12 06 08 10 12 06 08 10 06
03 01 02 03 04 01 02 03 04 01 02 03 01
09 05 07 09 11 05 07 09 11 05 07 09 05
21 21 21 21 21 21 21 21 21 21 21 21 21
