13 14 14 14 14 14 14 14 14 14 14 14 15
20 01 02 03 04 01 02 03 04 01 02 03 19
20 05 07 09 11 05 07 09 11 05 07 09 19
20 06 08 10 12 06 08 10 12 06 08 10 19
20 01 02 03 04 01 02 03 04 01 02 03 19
20 05 07 09 11 05 07 09 11 05 07 09 19
20 06 08 10 12 06 08 10 12 06 08 10 19
20 01 02 03 04 01 02 03 04 01 02 03 19
20 05 07 09 11 05 07 09 11 05 07 09 19
16 17 17 17 17 17 17 17 17 17 17 17 18
