13 14 14 14 14 14 14 14 14 14 14 14 15
20 21 21 21 21 21 21 21 21 21 21 21 19
20 21 21 21 14 14 14 14 14 14 21 21 19
20 21 21 21 21 21 21 21 21 21 21 21 19
20 21 21 21 17 17 17 17 17 17 21 21 19
20 21 21 21 21 21 21 21 21 21 21 21 19
20 21 21 21 21 21 21 21 21 21 21 21 19
20 21 21 21 21 21 21 21 21 21 21 21 19
20 21 21 21 21 21 21 21 21 21 21 21 19
16 17 17 17 17 17 17 17 17 17 17 17 18
