22 22 22 22 22 22 22 22 22 22 22 22 22
22 22 22 22 22 22 22 22 22 22 22 22 22
22 22 22 22 22 22 22 22 22 22 22 22 22
22 22 22 22 22 22 22 22 22 22 22 22 22
23 24 25 23 24 23 24 23 24 23 24 23 24
23 24 23 24 23 24 23 25 23 24 23 24 23
23 24 25 23 24 23 24 23 24 23 24 23 24
22 22 22 22 22 22 22 22 22 22 22 22 22
22 22 22 22 22 22 22 22 22 22 22 22 22
21 21 21 21 21 21 21 21 21 21 21 21 21
