13 14 14 14 14 15 26 27 13 14 14 14 15
20 21 21 21 21 19 28 29 20 21 21 21 19
20 21 21 21 21 21 21 21 21 21 21 21 19
20 21 21 21 21 21 21 21 21 21 21 21 19
20 21 21 21 21 21 21 21 21 21 21 21 21
20 21 21 21 21 21 21 21 21 21 21 21 21
20 21 21 21 21 21 21 21 21 21 21 21 19
20 21 21 21 21 21 21 21 21 21 21 21 19
20 21 21 21 21 21 21 21 21 21 21 21 19
16 17 17 17 17 17 17 18 21 21 16 17 18
